2
0
20 40
LLLLLLLLLLLLLLLLLLLLLLLLLLLLLLLLLLLLLLLL
LLL########LLLLLLLLLLLLLLLLLLLLLLLLLLLLL
LLLFFFFFFF#LLLLLLLLLLLLLLLLLLLLLLLLLLLLL
LLLFFFFFFF#LLLLLLLLLLLLLLLLLLLLLLLLLLLLL
LLL########LLLLLLLLLLLLLLLLLLLLLLLLLLLLL
LLLLLLLL#LLLLLLLLLLLLLLLLLLLLLLLLLLLLLLL
LLLLLLLL#LLLLLL###LLLLLLLLLLLLLLLLLLLLLL
LLLLLLLL############_LLLLLLLLLLLLLLLLLLL
LLLLLLLL#LLLLL######LLLLLLLLLLLLLLLLLLLL
LLLLLLLL#LLLLLWWWWWWLLLLLLLLLLLLLLLLLLLL
LLLLL####LLLLLWW_WWWLLLLLLLLLLLLLLLLLLLL
LLLLLLLLLLLLLLLLLLLLLLLLLLLLLLLLLLLLLLLL
LLLLLLLLLLLLLLLLLLLLLLLLLLLLLLLLLLLLLLLL
LLLLLLLLLLLLLLLLLLLLLLLLLLLLLLLLLLLLLLLL
LLLLLLLLLLLLLLLLLLLLLLLLLLLLLLLLLLLLLLLL
LLLLLLLLLLLLLLLLLLLLLLLLLLLLLLLLLLLLLLLL
LLLLLLLLLLLLLLLLLLLLLLLLLLLLLLLLLLLLLLLL
LLLLLLLLLLLLLLLLLLLLLLLLLLLLLLLLLLLLLLLL
LLLLLLLLLLLLLLLLLLLLLLLLLLLLLLLLLLLLLLLL
LLLLLLLLLLLLLLLLLLLLLLLLLLLLLLLLLLLLLLLL
Player 4 4
ColourDoor 7 20 red false
Key 10 16 red
Enemy line 8 15 left
Enemy line 8 17 left
Enemy line 8 18 right
Enemy line 8 8 up
Enemy smart 1 3